111111111111111111111111111
1P110000C0C0000000000000C11
101110111111100011111011011
1000000000000000C0000011111
101110111111101111110000001
1011100000C0110100010111111
10000001010010110001000CCC1
1C110011E110100010001111C11
111101111111111111111111111
111101111
111101111
11110111111111111111111111y