1111111
1E00001
1010001
1010101
1P000C1
1111111
