11111111111
1E0000C0001
10000000001
1000C000001
10000000001
1000P000001
11111111111