111111111111111111111111111
1P11E0000000000000000000C11
101111111111111111111011011
1000000000000000C0000011111
101110111111101111110000001
101110000000110100010111111
100000000000101100010000001
101110100010100010001111011
111111111111111111111111111

