111111111111111111111111111
1P000000C110000C0CCCC000101
101100111110111C0CCCC000101
101100111110001C0CCC1100101
100000000000100C0C11C010001
100111100110100C0CCCC000101
100100100110100C0CCCC0001C1
100000100110000C0CCCC0001C1
111111111111111111111111111

