11111111111
1CCCCCCCCC1
1CCCP0CCCC1
1CCCECCCCC1
1CCCCCCCCC1
1CCCCCCCCC1
11111111111