11111111111
1CCCCCCCCC1
1CCCPCCCCC1
1CCCECCCCC1
1CCCCCCCCC1
1CCCCCCCCC1
11111111111