1111111111
1P000000C1
1011001101
1011001101
1000110001
1P01111001
1001001001
1000000001
1000000001
1111111111
1111111111
1111111111