1111111111111
1111000001111
1100000000011
1100CCCCC0011
100C00000C001
100C00C00C001
100C0CPC0C001
100C00C00C001
100C00000C001
1100CCCCC0011
1100000000011
111100E001111
1111111111111