1111111111111111111111111111111111
1111000110000100C10100000000011111
10110101001000001010010CC000110111
10100110101010111011010CC000010101
100000000C00C001000101000000000001
1101010101101111010000111111011101
11C111C1111000000111101111110111P1
1111111111111111011110000000011111
1111011111100C00011111101111111111
111111011110111110110000C0C0C0C011
1111111100001110101111111111111111
11111111E1011010111111111111111111
1111111111111111111111111111111111